========================================
=     =      =     =     =     =     =  
=  =  P  =      =  =   V     =    =    =
=                   =    =     =    =  =
=  ==  ==  ==  ==  = =     =     =    = 
=                 V                     
=                                       
=         V                             
=                                       
=                   H                  =
=                                      X
=      =          = = =         =    = =
=              =        =     =      = =
=                 =    =     =       = =
=        =   =       =       =   =======
=          =      =    =     =     = = =
=  V              V        V   = =   = =
=                                      =
=                                      =
=              E               H       =
=                                      =
=                                      =
=                          H           =
=                     H                =
=                                      =
=                        E             =
=     E                                =
=                                      =
=                                      =
========================================