========================================
=     =      =     =     =     =     =  
=  =  P  =      =  =  ==     =    =    =
=                   =    =     =    =  =
=  ==  ==  ==  ==  = = X   =     =    = 
=                 =     X               
=                        X              
=         =               X             
=                          X            
=             ==========================
=                                      X
=      =          = = =         =    = =
=              =        =     =      = =
=                 =    =     =       = =
=        =   =       =       =   =======
=          =      =    =     =     = = =
=  V              V        V   = =   = =
=                                      =
=                                      =
=              E               H       =
=                                      =
=                                      =
=                          H           =
=                     H                =
=                                      =
=                        E             =
=     E                                =
=                                      =
=                                      =
========================================